1111111111
1P0Z0000C1
1000110001
1C10CC01C1
1000110001
1C10CC01C1
1000110001
1C10CC01C1
1000110001
1C000000E1
1111111111