1111111111
1P00000001
1000110001
1010000101
1000110001
1010000101
1000110001
1010000101
1000110001
10000000E1
1111111111