1111111111111111111
1111110011111111111
1111110C11111111111
1000C00000C0000C001
100000P000000000001
1C0000C00000C000001
1000C01011100000001
11C1011C1111100C111
110C011111111E11111
1111111111111111111