1111111111111111111
1111110011111111111
1111110111111111111
1000000000000000001
1000000000000P00001
1100000000001C00001
1000111111100C00001
1111111111111000111
1111111111111E11111
1111111111111111111