1111111111111111111
10C0110011111111111
11EP110C11111111111
1000C00000C0000C001
1000000000000000001
1C0000C00000C000001
1000C11111100000001
111111111111100C111
1111111111111E11101
1111111111111111111